|||||||||||||||||||||||||||
|S ||        |  | E |||||||
|  ||        |  |   |||||||
|      ||||  |  |         |
|      |  |  |  ||||||||  |
||||||||  |     |         |
|         ||||  |  ||||||||
| ||||||     |  |         |
| |    |  ||||  ||||||||  |
|      |        |         |
||||||||||||  |||  ||||||||
|     |  |||    |         |
|  |     |||||  ||||||||  |
|  ||||  |||||  ||||||||  |
|  ||||         |      |  |
|  ||||||||||||||         |
|                  ||||||||
|||||||||||||||||||||||||||