|||||||||||||||||||||||||||||||||||||||||||||||||||||||||||||||||||||||||||||||||||||||||||
|S       |        |     |           |              |                       |     |  |     |
|  |||||||  ||||  |  |  |  |  ||||  |  ||||||||||  ||||  ||||||||||  ||||  |  ||||  ||||  |
|              |     |     |  |  |  |  |     |     |        |        |        |  |        |
|  ||||  ||||  |||||||  |||||||  |  |  ||||  |  ||||||||||  ||||||||||  |||||||  |  ||||  |
|  |     |     |     |        |     |     |  |        |        |  |  |        |  |  |     |
|||||||  ||||  |  ||||||||||  |  ||||  ||||  ||||  |  |  |||||||  |  |  ||||  |  |||||||  |
|  |  |     |     |     |  |  |        |           |  |           |     |     |  |        |
|  |  ||||  ||||  |  ||||  |  |||||||  |||||||||||||  ||||||||||  |||||||||||||  |  |  ||||
|           |     |     |     |     |     |  |  |                                   |  |  |
|||||||  |  |  ||||  |||||||||||||  ||||  |  |  ||||||||||  |  |  |  |  ||||||||||||||||  |
|        |  |  |  |        |                 |     |  |     |  |  |  |  |           |     |
||||  |  |  ||||  |  |  ||||  |  ||||  |||||||  |  |  |  |  ||||  ||||  |  |||||||||||||  |
|     |  |     |  |  |     |  |  |  |     |     |     |  |  |  |  |  |                    |
||||  |  |  ||||  |  |  |  |  ||||  |  |  |  ||||  |  ||||  |  ||||  ||||  |  |||||||||||||
|  |  |  |  |     |  |  |        |  |  |     |     |  |  |     |  |  |     |  |  |     |  |
|  |  |  ||||  |  |  |||||||  ||||  |  |  ||||  ||||  |  |  |  |  |  |  ||||  |  |  ||||  |
|     |     |  |  |        |     |     |  |  |     |  |  |  |     |     |           |  |  |
|  ||||  ||||  ||||||||||||||||||||||  ||||  |  |||||||  |  |  |  |||||||  ||||  |  |  |  |
|  |  |  |           |        |        |     |  |           |  |     |  |     |  |  |     |
|  |  ||||  |  |  |  |||||||  |||||||||||||  |  ||||  |||||||||||||  |  |  ||||  |  ||||  |
|        |  |  |  |     |        |        |  |  |  |  |     |  |  |  |     |     |        |
|||||||  ||||  |||||||  |  |  ||||  |||||||  ||||  |  |  ||||  |  |||||||||||||  ||||  |  |
|                 |        |  |        |     |     |  |  |  |     |  |           |     |  |
|  ||||||||||  ||||  |  |  ||||||||||  ||||  |  |||||||  |  |  ||||  ||||  ||||||||||  ||||
|  |        |  |  |  |  |  |     |  |     |  |  |     |     |  |     |  |        |  |     |
|  ||||  |||||||  ||||  |||||||  |  |  |  |  |  |  |||||||  |  ||||  |  |||||||  |  |||||||
|     |  |              |     |     |  |           |        |     |                 |     |
|  ||||  |  |||||||  ||||  |  |  |  |  |  ||||  |  |  ||||  ||||  |  ||||||||||  ||||  ||||
|     |  |     |  |     |  |     |     |  |     |  |  |              |        |        |  |
|||||||  |  |  |  ||||  ||||||||||  ||||  ||||  |  |  |  |  ||||  ||||  ||||||||||  ||||  |
|     |  |  |     |                    |  |     |  |  |  |     |  |  |  |     |           |
|  ||||  |||||||||||||  ||||  |||||||  ||||  |  |  |||||||||||||  |  |  ||||  ||||  ||||  |
|        |           |     |  |        |  |  |  |  |  |  |     |              |  |  |     |
|||||||  |  |  ||||  |  ||||  ||||||||||  |  ||||  |  |  ||||  |  ||||  |  ||||  |||||||  |
|     |     |  |  |        |     |           |  |     |  |     |     |  |           |  |  |
|  ||||||||||  |  ||||  |  ||||  ||||||||||  |  |||||||  ||||  |  ||||  |  |  ||||  |  |  |
|     |     |  |  |  |  |     |  |                    |        |  |     |  |  |  |  |  |  |
|  |||||||  |  |  |  |||||||  ||||  |||||||||||||  |  |  ||||||||||  ||||  ||||  |  |  ||||
|           |        |     |     |        |        |     |        |     |  |  |           |
|  |  ||||||||||||||||  |||||||  ||||  |||||||  |  ||||||||||  |  ||||||||||  |  |  |  ||||
|  |        |           |     |     |  |     |  |  |  |     |  |  |        |     |  |     |
|  ||||||||||  |  |  |||||||  |  ||||  |  ||||  ||||  |  ||||  |||||||  |  ||||  ||||  ||||
|           |  |  |  |  |        |        |     |  |        |  |     |  |  |     |        |
||||||||||  |  |  ||||  |||||||  |  |||||||  ||||  |  |  |  |  |  ||||  |  |  |||||||||||||
|  |           |        |  |     |        |     |     |  |           |  |  |     |  |     |
|  |||||||  |  ||||  ||||  ||||  ||||||||||||||||  |  |||||||||||||||||||  ||||  |  |  ||||
|  |        |  |           |        |  |        |  |     |        |  |           |  |  |  |
|  ||||  |  ||||||||||  |||||||  |  |  |  |  ||||  |  |||||||  ||||  ||||  ||||  |  |  |  |
|        |  |     |        |     |        |     |  |        |     |           |     |     |
||||  |  |  |  |  |  ||||||||||  |||||||  ||||||||||||||||  ||||  |  |  ||||  ||||  ||||  |
|     |  |  |  |  |           |     |        |  |     |  |  |     |  |  |  |     |     |  |
|||||||  ||||  |  ||||  ||||  ||||  ||||  ||||  ||||  |  |  |  ||||  ||||  |  ||||  ||||  |
|  |     |  |  |     |  |           |  |              |  |              |     |  |  |     |
|  |||||||  |  ||||||||||  |||||||  |  |  |||||||  ||||  ||||||||||  |||||||  |  ||||  |  |
|  |  |  |     |              |     |  |  |        |  |  |  |     |  |        |  |     |  |
|  |  |  |  |  ||||  ||||  |  |||||||  |  |  |  |  |  |  |  |  |  |  |||||||  |  ||||  ||||
|  |     |  |  |  |  |  |  |  |  |     |  |  |  |           |  |        |     |  |        |
|  |  |||||||  |  ||||  |  ||||  ||||  |  |  |  ||||||||||  ||||  |  ||||  |  |  |  ||||  |
|                                      |  |  |     |        |     |  |     |           |E |
|||||||||||||||||||||||||||||||||||||||||||||||||||||||||||||||||||||||||||||||||||||||||||
