||||||||||||||||||||||||||||||||||||||||||||||||||||
|S ||        |  |            |   |    |||||||  |||||
|  ||        |  |   |||||||           |||||||  |||||
|      ||||  |  |         |||||  ||||||||||||  |||||
|      |  |  |  ||||||||  |             ||     |||||
||||||||  |     |         |  |||||||||  ||  ||||||||
|         ||||  |  ||||||||  |||||          ||||||||
| ||||||     |  |         |     ||||||||||  ||||||||
| |    |  ||||  ||||||||  ||||  ||||  ||||         |
|      |        |         |              ||||||||  |
||||||||||||  |||  ||||||||                        |
|     |  |||    |         |||||||||||||||||||||  |||
|  |     |||||  ||||||||  |         ||||||||||   |||
|  ||||  |||||  ||||||||  |                        |
|  ||||         |      |  |         ||||||||||     |
|  ||||||||||||||         |||  |||||||      ||||||||
|                  ||||||||             ||        E|
||||||||||||||||||||||||||||||||||||||||||||||||||||